1010101010000000000	稻谷	7%
1010101020000000000	小麦	9%
1010101030000000000	玉米	9%
1010101040000000000	谷子	9%
1010101050000000000	高粱	8%
1010101060000000000	大麦	9%
1010101070000000000	燕麦	10%
1010101080000000000	黑麦	9%
1010101090000000000	荞麦	9%
1010101990000000000	其他谷物	9%
1010102010000000000	马铃薯	9%

